C 20,197,  176
F 204,197,176
NO textures/wolfenstein/mossy.xpm
SO textures/wolfenstein/color_stone.xpm
WE textures/wolfenstein/eagle.xpm
EA textures/wolfenstein/grey_stone.xpm
        1111111111111111111111111
        1010000001100000000000001
        1111000001110000000000001
        1001000000000000000000001
1111111110110000001110000000000001
110000000011000001110111110111111
1111011111111101N1000000100011101
11110111111111011101010010001  1   
110000001101010111000000010001
100000000000100001100000010001
10000000000000011010100100011
110000011101010101110111100011
111101111111010111101111100001
11111111 1111111 1111111111111