C 139,0,12
F 64,64,255

NO textures/lsd.xpm
SO textures/lsd.xpm
WE textures/lsd.xpm
EA textures/lsd.xpm

1111111111111111111
1000000000S00000001
1000000000000000001
1001110011000001101
1001000001111111110
1001000000000000011
1001111110000111111
1001111111111111111
1000000000000000001
1000000000000000001
1111111111111111111

